EA            ee
NO aaaa
WE a
SO a		s
EA a	
EA b


111111
1001
1E111
1111
