WE a
NO b
F 12,12,12
EA   c
    SO       d
C 34,34,34





11111111   
11111101    111111
10000001    100011
100000011   111001
10000011    110001
10000001   11111111
10000001
1000W001
10000011
10001111
11111111
