F 233,233,233   
C 204,200,1
   EA 	O	
  WE 	P	
  NO betin		

SO 	A	 	 	



      
1111111      111111111111 11111
100000111
111110001111111111111111111
11111101111111   111     11
100S0000101
111111111111     111        111111111
1
1
111111111       
