F 233,233,233   
C 204,200,1
   EA 	O	
  WE 	P	
  NO betin		

SO 	A	 	 	



      
11111111111111111111111111111111
1001                    1S1
1011                  1111111
101
111
1
