F 233,233,233,4 
C 204,200,1
   EA 	O	
  WE 	P	
  NO betin		

SO 	A	 	 	



      
11111111111111111111111111111111
10N01                    101
10111                  1111111
10111111111111111111111101111
111000111111100001   1111111111
1111111111111111111111111111
11110101
11111111
