F 233,233,233   
C 204,200,1
   EA 	O	
  WE 	P	
  NO betin		

SO 	A	 	 	



11111
110E1
10001
11001
11111
                   
