F 233,233,233   
C 204,200,1
   EA 	O	
  WE 	P	
  NO betin		

SO 	A



11111111111111
10111111011111
1E1101 111
11111111111111
