F 233,233,233,   
C 204,200,1
   EA 	O		
  NO betin		
SO 	A
WE aa


11111111111111
100111111011111
1E1101 111
11111111111111
