F 233,233,233,   
C 204,200,1
   EA 	O		
  NO betin		
SO 	A
WE aa


11111111111111
1000E111
111111111111
1

11
